1111111
1P00001
1000001
100E0C1
1000001
1CCCCC1
1111111