111111111111111111111111111111
1000000000P000000000000000CC01
1E0000000111100000C00000000001
1CC00000000000000C000000C00011
111111111111111111111111111111