1111111111111111111
1111111111111111111
1111111111111111111
111111111111111PCE1
1111111111111111111