11111111
10000P01
1C000E01
11111111